1111111111
1001000001
1000011001
1000000001
1001000001
1001111001
1000000001
1000000001
1111001001
1000001001
1000001001
1111001001
1000001001
10$0000001
1111111111